********************************
*                              *
*                              *
****       ********        *****
****       ********        *****
*                              *
*                              *
***********              *******
*                              *
********************************