********************
*                  *
*                  *
****    ****    ****
****    ***     ****
*       +@         *
*                  *
***********    *****
*                  *
********************
