********************
*     #            *
*                  *
*                  *
*        @         *
*                  *
*                  *
*                  *
*         +        *
*                  *
********************
